111111
1PC0E1
101001
111111


